width=40
height=40
startLeft=4
startTop=3
startBottom=4
startRight=7

##.###.#####.###.#####.###.#####.###.###
....##.###....##.###....##.###....##.###
###.##.######.##.######.##.######.##.###
##.....#####.....#####.....#####.....###
###....######....######....######....###
###....######....######....######....###
........................................
###.##.######.##.######.##.######.##.###
###.##.######.##.######.##.######.##.###
###.##.######.##.######.##.######.##.###
##.###.#####.###.#####.###.#####.###.###
....##.###....##.###....##.###....##.###
###.##.######.##.######.##.######.##.###
##.....#####.....#####.....#####.....###
###....######....######....######....###
###....######....######....######....###
........................................
###.##.######.##.######.##.######.##.###
###.##.######.##.######.##.######.##.###
###.##.######.##.######.##.######.##.###
##.###.#####.###.#####.###.#####.###.###
....##.###....##.###....##.###....##.###
###.##.######.##.######.##.######.##.###
##.....#####.....#####.....#####.....###
###....######....######....######....###
###....######....######....######....###
........................................
###.##.######.##.######.##.######.##.###
###.##.######.##.######.##.######.##.###
###.##.######.##.######.##.######.##.###
##.###.#####.###.#####.###.#####.###.###
....##.###....##.###....##.###....##.###
###.##.######.##.######.##.######.##.###
##.....#####.....#####.....#####.....###
###....######....######....######....###
###....######....######....######....###
........................................
###.##.######.##.######.##.######.##.###
###.##.######.##.######.##.######.##.###
###.##.######.##.######.##.######.##.###
