width=40
height=40
startLeft=33
startTop=20
startBottom=20
startRight=8
startCenter=8,8
#....##.##.###.###..#....##.##.###.###..
#....##.##.###.###..#....##.##.###.###..
#....##.##.###.###..#....##.##.###.###..
#....#.M..########..#....#....########..
##..#......#######..##..#......#######..
##.####..#########M.##.####..#########..
###.........######..###.........######..
...E...........................E........
#....##.##.###.###..#....##.##.###.###..
#....##.##.###.###..#....##.##.###.###..
#....##.##.###.###..#.E..##.##.###.###..
#....##.##.###.###..#....##.##.###.###..
#....##.##.###.###..#....##.##.###.###..
#....#....########..#....#....########..
##..#......#######..##..#......#######..
##.####..#########..##.####..#########..
###...M.....######..###.........######..
........................................
#....##.##.###.###..#....##.##.###.###..
#....##.##.###.###M.#....##.##.###.###..
#.E..##.##.###.###..#..E.##.##.###.###..
#....##.##.###.###..#....##.##.###.###..
#....##.##.###.###..#....##.##.###.###..
#....#....########..#....#....########..
##..#..E...#######..##..#......#######..
##.####..#########..##.####..#########..
###....M....######..###..M......######..
...............................E........
#M...##.##.###.###..#....##.##.###.###..
#....##.##.###.###..#.M..##.##.###.###..
#....##.##.###.###..#....##.##.###.###..
#..E.##.##.###.###..#....##.##.###.###..
#....##.##.###.###..#....##.##.###.###..
#....#....########..#....#....########..
##..#......#######..##..#..E...#######..
##.####..#########..##.####..#########..
###.....M...######..###.........######..
##...........#####..##..M........#####..
.....E............................E.....
..M............................M.........
