width=40
height=40
startLeft=32
startTop=17
startBottom=17
startRight=9
startCenter=17,17
...########.........##########.......####
...####......#.#....######......#.#..##..
....####.....#.#..M..######.....#.#.M##..
#....####....#.#......######....#.#..##..
#.....#####..#.#.......#######..#.#..##..
#....#####...#.#......######....#.#..##..
#...####.....#.#.....######..E..#.#..##..
#######...E..#.#..########......#.#..##..
.............................M...........
...####......#.#....######......#.#..##..
....####....M.#.#.....######.....#.#..##..
#....####....#.#......######....#.#..##..
#.....#####..#.#.......#######..#.#..##..
#....#####...#.#E.....######....#.#..##..
#...####.....#.#.....######.....#.#..##..
#######......#.#M.########...E..#.#..##..
.........................................
...####...E..#.#....######......#.#..##..
....####.....#.#.....######..E..#.#..##..
#....####....#.#......######....#.#..##..
#.....#####..#.#..M....#######..#.#..##..
#....#####...#.#......######....#.#..##..
#...####.....#.#.....######.....#.#..##..
#######E.....#.#..########..M...#.#..##..
.........................................
...####......#.#....######......#.#..##..
....####.....#.#.....######.....#.#..##..
#....####....#.#..E...######....#.#..##..
#..M..#####..#.#.......#######..#.#..##..
#....#####...#.#......######....#.#M.##..
#...####.....#.#.....######.....#.#..##..
#######......#.#..########......#.#..##..
.........................................
...####......#.#....######......#.#..##..
....####.E...#E#.....######.M...#.#..##..
#....####....#.#......######....#.#..##..
#.....#####..#.#.......#######..#.#..##..
#M...#####...#.#..M...######....#.#..##..
#...####.....#.#.....######.....#.#.E##..
.....E...............................M...
