width=26
height=25
startLeft=2
startTop=5
startBottom=4
startRight=2
startCenter=8,12
####.#####################
####M######.....M.........
####.######.##.####.##.###
####.##....E##.####.##.###
####.##.###.##.##.#.##M###
####.##.###.##.##.#.##.###
####.##M###.##.##.#.##.###
####.##.###.##.##.#.##.###
####.##.###.##.##E#.##.###
####.##.###.##M##.#.##.###
####.##.###.##.##.#.##.###
####M##.###.##.##.#.##.###
####.##.###.##.##.#.##.###
####.##.###.##.##.#.##.###
####.##.###.##....#.##.###
####.##.###.###.###.##.###
####.##.###.###.###.##.###
####.##.###.###.###.##.###
####.##.###.###E###.##.###
####.######.###.###.##.###
####.######.###.###.##.###
####.......E###.###.##.###
###################E##.###
......M.............##E###
######################.###
