width=40
height=40
startLeft=33
startTop=13
startBottom=13
startRight=8
startCenter=13,8
########.....##########......##########..
########.....##########......##########..
...##.....#......##.......#......##......
M..##.....#......##.......#......##......
...##.....#...E..##.......#......##......
...##.....#......##.......#......##......
...##............##M.............##...M..
....E......................E.............
########.....##########......##########..
...##.....#......##.......#......##......
...##.....#......##.......#......##......
...##.....#......##.......#......##......
...##..E..#......##.......#......##......
...##............##.M............##......
....................................E....
########.....##########......##########..
...##.....#......##.......#......##......
...##.M...#......##.......#......##......
...##.....#......##.......#......##.M....
...##.....#......##E......#......##......
...##..E.........##..............##......
########.....##########......##########..
.........................................
...##.....#......##.......#......##......
...##.E...#......##.E.....#......##......
...##.....#......##.......#......##..M...
...##.....#..M...##.......#......##......
...##............##..............##......
########.....##########......##########..
.........................................
...##.....#......##.E.....#......##......
...##.....#.M....##.......#......##E.....
...##.....#......##.......#......##......
...##.....#......##.......#...M..##......
...##............##..............##......
########.....##########......##########..
........M................................
...##.E...#......##.......#......##......
...##.....#......##.......#......##..M...
.E.....M...........................E.....
