width=26
height=25
startLeft=9
startTop=6
startBottom=6
startRight=7
startCenter=11,9
#####.#########.##########
#####.#########.##########
..........................
##.......###.............#
..........................
####...#####.....#####...#
..........................
####...#######...#########
..........................
####...#######......######
..........................
####...#######......######
..........................
####...#######...#########
..........................
##.......#####...#########
..........................
#####.#########.##########
#####.#########.##########
#####.#########.##########
#####.#########.##########
#####.#########.##########
#####.#########.##########
#####.#########.##########
#####.#########.##########
