width=40
height=40
startLeft=34
startTop=11
startBottom=11
startRight=7
startCenter=11,7
######......#######.....#######........##
######......#######..M..#######........##
######......#######...E.#######........##
.######....#######.......#######......##.
..######..#######.........########...##..
...######.######...........########.##.E.
M.....E.................M................
######.M....#######.....#######........##
######......#######.....#######........##
######......#######.....#######........##
.######....#######E......#######......##.
..######..#######.........########...##..
...######.######...........########.##...
.......................M.............E...
######......#######.....#######........##
######...M..#######.....#######........##
######......#######.....#######........##
.######....#######.......#######......##.
..######..#######.........########...##..
...######.######...........########.##...
..................M......................
######......#######.....#######........##
######......#######.....#######E.......##
######..E...#######.....#######........##
.######....#######.......#######......##.
..######..#######.........########...##..
...######.######...........########.##...
.........................................
######......#######.....#######........##
######...M..#######.....#######........##
######......#######E....#######M.......##
.######....#######.......#######......##.
..######..#######.........########...##..
...######.######...........########.##...
.........................................
######......#######.....#######........##
######......#######.....#######........##
######......#######.....#######........##
.######..E.#######.......#######......##.
..######..#######M........########...##M.
