width=26
height=25
startLeft=4
startTop=12
startBottom=12
startRight=10
startCenter=12,10
##.########.####.#########
##.########.####.#########
##.########.####.#########
##....E...............E...
##M##.####################
##.##.####################
...##..........M..........
##.##.####################
##.##.####################
##...E.............E......
##.###.###.#####.#########
##.###.###.#####.#########
##.###.###.#####M.........
##.###.###.#####.#########
##.###.###.#####.#########
....E............#########
##.#######.###############
##.#######...E.......M....
##.########.######.####.##
##.########.######.####.##
##.########.######.####.##
....M.......#####...###.##
##.########.######M####.##
##.########.###########.##
##.########.###########.##
