width=26
height=25
startLeft=10
startTop=4
startBottom=8
startRight=8
startCenter=8,10
###.##############.#######
###.##############.#######
###.##########.....M.#####
###.############.##.######
.....##M.........##.######
####.##.########.##.######
####.##.########.##.######
##...E................M...
##.####.########.###.#####
...####.########.###.#####
#######.########.###E#####
#######.########.###.#####
#####M#.########.###.#####
#####.#.########.###.M####
#####....#######.###.#####
........########E###.####.
##.###..M.................
##.####.########.######.##
##.####.########.######E##
##.####.########.######.##
##.E........E........M....
#######.########.#########
#######E########.#########
#######.########.#########
#######.########.M########
