width=26
height=25
startLeft=10
startTop=4
startBottom=8
startRight=8
startCenter=8,10
###.##############.#######
###.##############.#######
###.##########.......#####
###.############.##.######
.....##..........##.######
####.##.########.##.######
####.##.########.##.######
##........................
##.####.########.###.#####
...####.########.###.#####
#######.########.###.#####
#######.########.###.#####
#####.#.########.###.#####
#####.#.########.###..####
#####....#######.###.#####
........########.###.####.
##.###....................
##.####.########.######.##
##.####.########.######.##
##.####.########.######.##
##........................
#######.########.#########
#######.########.#########
#######.########.#########
#######.########..########
