width=26
height=25
startLeft=2
startTop=5
startBottom=23
startRight=2
startCenter=8,12
####.#####################
####.######...............
####.######.##.####.##.###
####.##.....##.####.##.###
####.##.###.##.##.#.##.###
####.##.###.##.##.#.##.###
####.##.###.##.##.#.##.###
####.##.###.##.##.#.##.###
####.##.###.##.##.#.##.###
####.##.###.##.##.#.##.###
####.##.###.##.##.#.##.###
####.##.###.##.##.#.##.###
####.##.###.##.##.#.##.###
####.##.###.##.##.#.##.###
####.##.###.##....#.##.###
####.##.###.###.###.##.###
####.##.###.###.###.##.###
####.##.###.###.###.##.###
####.##.###.###.###.##.###
####.######.###.###.##.###
####.######.###.###.##.###
####........###.###.##.###
###################.##.###
....................##.###
######################.###
