width=26
height=25
startLeft=9
startTop=6
startBottom=11
startRight=7
startCenter=11,9
#####.#########.##########
#####.#########.##########
..M................E......
##.......###.............#
.........E................
####...#####.....#####M..#
..........................
####..E#######...#########
..........................
####...#######....M.######
..........................
####E..#######......######
....................E.....
####...#######...#########
..........................
##M.....M#####...#########
..........................
#####.#########.##########
#####E#########.##########
#####.#########.##########
#####.#########.##########
#####.#########.##########
#####.#########M##########
#####.#########.##########
#####.#########.##########
