width=26
height=25
startLeft=14
startTop=14
startBottom=14
startRight=12
startCenter=14,10
###########...############
##########..#...##########
########...###...#########
#######..#######..########
######..#########...######
####...###########...#####
###..###############..####
###.#################.####
###.#################.####
###.######.....######.####
###.######.##########.####
...........###............
###.######.#...######.####
###.######.###.######.####
###.######.###.######.####
###.######.....######.####
###.#################.####
###...##############..####
####...###########...#####
######...########...######
#######...######..########
#########...##...#########
##########......##########
############..############
############..############
