width=26
height=25
startLeft=14
startTop=14
startBottom=13
startRight=12
startCenter=14,10
###########...############
##########.E#...##########
########...###...#########
#######..#######..########
######..#########...######
####..M###########...#####
###..###############M.####
###.#################E####
###.#################.####
###E######....M######.####
###.######.##########.####
.....E.....##...E.........
###.######.#M..######.####
###.######.###.######.####
###.######.###.######.####
###.######..E..######E####
###.#################.####
###.M.##############..####
####...###########...#####
######...########M..######
#######...######..########
#########...##...#########
##########..M...##########
############..############
############..############
